R   1000 1000
SO ./pics/bluestone.xpm
NO ./pics/227592.xpm
WE ./pics/purplestone.xpm
EA ./pics/colorstone.xpm
S ./pics/227592.xpm

F 0,130,50
C 80,60,180

11111111111
10000000001
1000000N001
11111111111