R 1000 1000
NO ./path_to_the_north_texture
SO ./path_to_the_south_texture
WE ./path_to_the_west_texture
EA ./path_to_the_east_texture
S ./path_to_the_sprite_texture

F 20,130,50
C 80,60,180


11111111111111111111111
10000000000000000000001
11111111111111111100001
10000000002000200000001
10000000000000000000001
10020000000000002000001
10000000000000000000001
10000000000000002000001
100000000N0000000000001
10000000000000002000001
10000200020000000000001
10000000000000002000001
10000000000000000000001
10000200000000002000001
10000000002000000000001
10000000000000000000001
10000000000000000000001
10000000002000000000001
10000000000000000000001
10000000000000000000001
10000000000000111111111
11111111111111111111111