R   500 500

S ./pics/bluestone.xpm
NO ./pics/227592.xpm
WE ./pics/purplestone.xpm
EA ./pics/colorstone.xpm
SO ./pics/227592.xpm

F 0,130,50
C 80,60,180

               111111111111111111111
               100000000000001000001
               100000000000001000001
               1000N0002000001000001
               100000002000001000001
               100000002000001000001
               100000002000001000001
               100000000000001000001
1111111   11111011111111111111101111
100011111110000000001111111111111111
11111111111011111111111
111111111111111111111
111111111111111111111
111111111110000000001
111111111 11111111111