R 230 150
NO ./path_to_the_north_texture
SO ./path_to_the_south_texture
WE ./path_to_the_west_texture
EA ./path_to_the_east_texture
S ./path_to_the_sprite_texture

F 255,255,255
C 255,20,0

11111111111111
10000000000001
10000000000001
10000000000001
10000000000001
10000000001111
10000000000011
10N00000000001
10000000000001
11111111111111