R 640 500

S ./pics/fire.xpm
NO ./pics/MOB.xpm
WE ./pics/purplestone.xpm
EA ./pics/colorstone.xpm
SO ./pics/eagle.xpm

C  250,10,10
F  0,250,10

1111111
1000S01
1002001
1002001
1002001
1002001
1002001
1002001
1002001
1002001
1002001
1002001
1002001
1002001
1002001
1002001
1002001
1002001
1002001
1002001
1002001
1002001
1002001
1002001
1002001
1002001
1002001
1002001
1002001
1002001
1002001
1002001
1002001
1002001
1002001
1002001
1002001
1002001
1002001
1002001
1002001
1002001
1002001
1002001
1002001
1002001
1002001
1002001
1002001
1002001
1002001
1002001
1002001
1002001
1002001
1002001
1002001
1002001
1002001
1002001
1002001
1002001
1002001
1002001
1002001
1002001
1002001
1002001
1002001
1002001
1002001
1002001
1002001
1002001
1002001
1002001
1002001
1002001
1002001
1002001
1002001
1002001
1002001
1002001
1002001
1002001
1002001
1002001
1002001
1002001
1002001
1002001
1002001
1002001
1002001
1002001
1002001
1002001
1002001
1002001
1002001
1002001
1002001
1002001
1002001
1002001
1002001
1002001
1002001
1002001
1002001
1002001
1002001
1002001
1002001
1002001
1002001
1002001
1002001
1002001
1002001
1002001
1002001
1002001
1002001
1002001
1002001
1002001
1002001
1002001
1002001
1002001
1002001
1002001
1002001
1002001
1002001
1002001
1002001
1002001
1002001
1002001
1002001
1002001
1002001
1002001
1002001
1002001
1002001
1002001
1002001
1002001
1002001
1002001
1002001
1002001
1002001
1002001
1002001
1002001
1002001
1002001
1002001
1002001
1002001
1002001
1002001
1002001
1002001
1002001
1002001
1002001
1002001
1002001
1002001
1002001
1002001
1002001
1002001
1002001
1002001
1002001
1002001
1002001
1002001
1002001
1002001
1002001
1002001
1002001
1002001
1002001
1002001
1002001
1002001
1002001
1002001
1002001
1002001
1002001
1002001
1002001
1002001
1002001
1002001
1002001
1002001
1002001
1002001
1002001
1002001
1002001
1002001
1002001
1002001
1002001
1002001
1002001
1002001
1002001
1002001
1002001
1002001
1002001
1002001
1002001
1002001
1002001
1002001
1002001
1002001
1002001
1002001
1002001
1002001
1002001
1002001
1002001
1002001
1002001
1002001
1002001
1002001
1002001
1002001
1002001
1002001
1002001
1002001
1002001
1002001
1002001
1002001
1002001
1002001
1002001
1002001
1002001
1002001
1002001
1002001
1002001
1002001
1002001
1002001
1002001
1002001
1002001
1002001
1002001
1002001
1002001
1002001
1002001
1002001
1002001
1002001
1002001
1002001
1002001
1002001
1002001
1002001
1002001
1002001
1002001
1002001
1002001
1002001
1002001
1002001
1002001
1002001
1002001
1002001
1002001
1002001
1002001
1002001
1002001
1002001
1002001
1002001
1002001
1002001
1002001
1002001
1002001
1002001
1002001
1002001
1002001
1002001
1002001
1002001
1002001
1002001
1002001
1002001
1002001
1002001
1002001
1002001
1002001
1002001
1002001
1002001
1002001
1002001
1002001
1002001
1002001
1002001
1002001
1002001
1002001
1002001
1002001
1002001
1002001
1002001
1002001
1002001
1002001
1002001
1002001
1002001
1002001
1002001
1002001
1002001
1002001
1002001
1002001
1002001
1002001
1002001
1002001
1002001
1002001
1002001
1002001
1002001
1002001
1002001
1002001
1002001
1002001
1002001
1002001
1002001
1002001
1002001
1002001
1002001
1002001
1002001
1002001
1002001
1002001
1002001
1002001
1002001
1002001
1002001
1002001
1002001
1002001
1002001
1002001
1002001
1002001
1002001
1002001
1002001
1002001
1002001
1002001
1002001
1002001
1002001
1002001
1002001
1002001
1002001
1002001
1002001
1002001
1002001
1002001
1002001
1002001
1002001
1002001
1002001
1002001
1002001
1002001
1002001
1002001
1002001
1002001
1002001
1002001
1002001
1002001
1002001
1002001
1002001
1002001
1002001
1002001
1002001
1002001
1002001
1002001
1002001
1002001
1002001
1002001
1002001
1002001
1002001
1002001
1002001
1002001
1002001
1002001
1002001
1002001
1002001
1002001
1002001
1002001
1002001
1002001
1002001
1002001
1002001
1002001
1002001
1002001
1002001
1002001
1002001
1002001
1002001
1002001
1002001
1002001
1002001
1002001
1002001
1002001
1002001
1002001
1002001
1002001
1002001
1002001
1002001
1002001
1002001
1002001
1002001
1002001
1002001
1002001
1002001
1002001
1002001
1002001
1002001
1002001
1002001
1002001
1002001
1002001
1002001
1002001
1002001
1002001
1002001
1002001
1002001
1002001
1002001
1002001
1002001
1002001
1002001
1002001
1002001
1002001
1002001
1002001
1002001
1002001
1002001
1002001
1002001
1002001
1002001
1002001
1002001
1002001
1002001
1002001
1002001
1002001
1002001
1002001
1002001
1002001
1002001
1002001
1002001
1002001
1002001
1002001
1002001
1002001
1002001
1002001
1002001
1002001
1002001
1002001
1002001
1002001
1002001
1002001
1002001
1002001
1002001
1002001
1002001
1002001
1002001
1002001
1002001
1002001
1002001
1002001
1002001
1002001
1002001
1002001
1002001
1002001
1002001
1002001
1002001
1002001
1002001
1002001
1002001
1002001
1002001
1002001
1002001
1002001
1002001
1002001
1002001
1002001
1002001
1002001
1002001
1002001
1002001
1002001
1002001
1002001
1002001
1002001
1002001
1002001
1002001
1002001
1002001
1002001
1002001
1002001
1002001
1002001
1002001
1002001
1002001
1002001
1002001
1002001
1002001
1002001
1002001
1002001
1002001
1002001
1002001
1002001
1002001
1002001
1002001
1002001
1002001
1002001
1002001
1002001
1002001
1002001
1002001
1002001
1002001
1002001
1002001
1002001
1002001
1002001
1002001
1002001
1002001
1002001
1002001
1002001
1002001
1002001
1002001
1002001
1002001
1002001
1002001
1002001
1002001
1002001
1002001
1002001
1002001
1002001
1002001
1002001
1002001
1002001
1002001
1002001
1002001
1002001
1002001
1002001
1002001
1002001
1002001
1002001
1002001
1002001
1002001
1002001
1002001
1002001
1002001
1002001
1002001
1002001
1002001
1002001
1002001
1002001
1002001
1002001
1002001
1002001
1002001
1002001
1002001
1002001
1002001
1002001
1002001
1002001
1002001
1002001
1002001
1002001
1002001
1002001
1002001
1002001
1002001
1002001
1002001
1002001
1002001
1002001
1002001
1002001
1002001
1002001
1002001
1002001
1002001
1002001
1002001
1002001
1002001
1002001
1002001
1002001
1002001
1002001
1002001
1002001
1002001
1002001
1002001
1002001
1002001
1002001
1002001
1002001
1002001
1002001
1002001
1002001
1002001
1002001
1002001
1002001
1002001
1002001
1002001
1002001
1002001
1002001
1002001
1002001
1002001
1002001
1002001
1002001
1002001
1002001
1002001
1002001
1002001
1002001
1002001
1002001
1002001
1002001
1002001
1002001
1002001
1002001
1002001
1002001
1002001
1002001
1002001
1002001
1002001
1002001
1002001
1002001
1002001
1002001
1002001
1002001
1002001
1002001
1002001
1002001
1002001
1002001
1002001
1002001
1002001
1002001
1002001
1002001
1002001
1002001
1002001
1002001
1002001
1002001
1002001
1002001
1002001
1002001
1002001
1002001
1002001
1002001
1002001
1002001
1002001
1002001
1002001
1002001
1002001
1002001
1002001
1002001
1002001
1002001
1002001
1002001
1002001
1002001
1002001
1002001
1002001
1002001
1002001
1002001
1002001
1002001
1002001
1002001
1002001
1002001
1002001
1002001
1002001
1002001
1002001
1002001
1002001
1002001
1002001
1002001
1002001
1002001
1002001
1002001
1002001
1002001
1002001
1002001
1002001
1002001
1002001
1002001
1002001
1002001
1002001
1002001
1002001
1002001
1002001
1002001
1002001
1002001
1002001
1002001
1002001
1002001
1002001
1002001
1002001
1002001
1002001
1002001
1002001
1002001
1002001
1002001
1002001
1002001
1002001
1002001
1002001
1002001
1002001
1002001
1002001
1002001
1002001
1002001
1002001
1002001
1002001
1002001
1002001
1002001
1002001
1002001
1002001
1002001
1002001
1002001
1002001
1002001
1002001
1002001
1002001
1002001
1002001
1002001
1002001
1002001
1002001
1002001
1002001
1002001
1002001
1002001
1002001
1002001
1002001
1002001
1002001
1002001
1002001
1002001
1002001
1002001
1002001
1002001
1002001
1002001
1002001
1002001
1002001
1002001
1002001
1002001
1002001
1002001
1002001
1002001
1002001
1002001
1002001
1002001
1002001
1002001
1002001
1002001
1002001
1002001
1002001
1002001
1002001
1002001
1002001
1002001
1002001
1002001
1002001
1002001
1002001
1002001
1002001
1002001
1002001
1002001
1002001
1002001
1002001
1002001
1002001
1002001
1002001
1002001
1002001
1002001
1002001
1002001
1002001
1002001
1002001
1002001
1002001
1002001
1002001
1002001
1002001
1002001
1002001
1002001
1002001
1002001
1002001
1002001
1002001
1002001
1002001
1002001
1002001
1002001
1002001
1002001
1002001
1002001
1002001
1002001
1002001
1002001
1002001
1002001
1002001
1002001
1002001
1002001
1002001
1002001
1002001
1002001
1002001
1002001
1002001
1002001
1002001
1002001
1002001
1002001
1002001
1002001
1002001
1002001
1002001
1002001
1002001
1002001
1002001
1002001
1002001
1002001
1002001
1002001
1002001
1002001
1002001
1002001
1002001
1002001
1002001
1002001
1002001
1002001
1002001
1002001
1002001
1002001
1002001
1002001
1002001
1002001
1002001
1002001
1002001
1002001
1002001
1002001
1002001
1002001
1002001
1002001
1002001
1002001
1002001
1002001
1002001
1002001
1002001
1002001
1002001
1002001
1002001
1002001
1002001
1002001
1002001
1002001
1002001
1002001
1002001
1002001
1002001
1002001
1002001
1002001
1002001
1002001
1002001
1002001
1002001
1002001
1002001
1002001
1002001
1002001
1002001
1002001
1002001
1002001
1002001
1002001
1002001
1002001
1002001
1002001
1002001
1002001
1002001
1002001
1002001
1002001
1002001
1002001
1002001
1002001
1002001
1002001
1002001
1002001
1002001
1002001
1002001
1002001
1002001
1002001
1002001
1002001
1002001
1002001
1002001
1002001
1002001
1002001
1002001
1002001
1002001
1002001
1002001
1002001
1002001
1002001
1002001
1002001
1002001
1002001
1002001
1002001
1002001
1002001
1002001
1002001
1002001
1002001
1002001
1002001
1002001
1002001
1002001
1002001
1002001
1002001
1002001
1002001
1002001
1002001
1002001
1002001
1002001
1002001
1002001
1002001
1002001
1002001
1002001
1002001
1002001
1002001
1002001
1002001
1002001
1002001
1002001
1002001
1002001
1002001
1002001
1002001
1002001
1002001
1002001
1002001
1002001
1002001
1002001
1002001
1002001
1002001
1002001
1002001
1002001
1002001
1002001
1002001
1002001
1002001
1002001
1002001
1002001
1002001
1002001
1002001
1002001
1002001
1002001
1002001
1002001
1002001
1002001
1002001
1002001
1002001
1002001
1002001
1002001
1002001
1002001
1002001
1002001
1002001
1002001
1002001
1002001
1002001
1002001
1002001
1002001
1002001
1002001
1002001
1002001
1002001
1002001
1002001
1002001
1002001
1002001
1002001
1002001
1002001
1002001
1002001
1002001
1002001
1002001
1002001
1002001
1002001
1002001
1002001
1002001
1002001
1002001
1002001
1002001
1002001
1002001
1002001
1002001
1002001
1002001
1002001
1002001
1002001
1002001
1002001
1002001
1002001
1002001
1002001
1002001
1002001
1002001
1002001
1002001
1002001
1002001
1002001
1002001
1002001
1002001
1002001
1002001
1002001
1002001
1002001
1002001
1002001
1002001
1002001
1002001
1002001
1002001
1002001
1002001
1002001
1002001
1002001
1002001
1002001
1002001
1002001
1002001
1002001
1002001
1002001
1002001
1002001
1002001
1002001
1002001
1002001
1002001
1002001
1002001
1002001
1002001
1002001
1002001
1002001
1002001
1002001
1002001
1002001
1002001
1002001
1002001
1002001
1002001
1002001
1002001
1002001
1002001
1002001
1002001
1002001
1002001
1002001
1002001
1002001
1002001
1002001
1002001
1002001
1002001
1002001
1002001
1002001
1002001
1002001
1002001
1002001
1002001
1002001
1002001
1002001
1002001
1002001
1002001
1002001
1002001
1002001
1002001
1002001
1002001
1002001
1002001
1002001
1002001
1002001
1002001
1002001
1002001
1002001
1002001
1002001
1002001
1002001
1002001
1002001
1002001
1002001
1002001
1002001
1002001
1002001
1002001
1002001
1002001
1002001
1002001
1002001
1002001
1002001
1002001
1002001
1002001
1002001
1002001
1002001
1002001
1002001
1002001
1002001
1002001
1002001
1002001
1002001
1002001
1002001
1002001
1002001
1002001
1002001
1002001
1002001
1002001
1002001
1002001
1002001
1002001
1002001
1002001
1002001
1002001
1002001
1002001
1002001
1002001
1002001
1002001
1002001
1002001
1002001
1002001
1002001
1002001
1002001
1002001
1002001
1002001
1002001
1002001
1002001
1002001
1002001
1002001
1002001
1002001
1002001
1002001
1002001
1002001
1002001
1002001
1002001
1002001
1002001
1002001
1002001
1002001
1002001
1002001
1002001
1002001
1002001
1002001
1002001
1002001
1002001
1002001
1002001
1002001
1002001
1002001
1002001
1002001
1002001
1002001
1002001
1002001
1002001
1002001
1002001
1002001
1002001
1002001
1002001
1002001
1002001
1002001
1002001
1002001
1002001
1002001
1002001
1002001
1002001
1002001
1002001
1002001
1002001
1002001
1002001
1002001
1002001
1002001
1002001
1002001
1002001
1002001
1002001
1002001
1002001
1002001
1002001
1002001
1002001
1002001
1002001
1002001
1002001
1002001
1002001
1002001
1002001
1002001
1002001
1002001
1002001
1002001
1002001
1002001
1002001
1002001
1002001
1002001
1002001
1002001
1002001
1002001
1002001
1002001
1002001
1002001
1002001
1002001
1002001
1002001
1002001
1002001
1002001
1002001
1002001
1002001
1002001
1002001
1002001
1002001
1002001
1002001
1002001
1002001
1002001
1002001
1002001
1002001
1002001
1002001
1002001
1002001
1002001
1002001
1002001
1002001
1002001
1002001
1002001
1002001
1002001
1002001
1002001
1002001
1002001
1002001
1002001
1002001
1002001
1002001
1002001
1002001
1002001
1002001
1002001
1002001
1002001
1002001
1002001
1002001
1002001
1002001
1002001
1002001
1002001
1002001
1002001
1002001
1002001
1002001
1002001
1002001
1002001
1002001
1002001
1002001
1002001
1002001
1002001
1002001
1002001
1002001
1002001
1002001
1002001
1002001
1002001
1002001
1002001
1002001
1002001
1002001
1002001
1002001
1002001
1002001
1002001
1002001
1002001
1002001
1002001
1002001
1002001
1002001
1002001
1002001
1002001
1002001
1002001
1002001
1002001
1002001
1002001
1002001
1002001
1002001
1002001
1002001
1002001
1002001
1002001
1002001
1002001
1002001
1002001
1002001
1002001
1002001
1002001
1002001
1002001
1002001
1002001
1002001
1002001
1002001
1002001
1002001
1002001
1002001
1002001
1002001
1002001
1002001
1002001
1002001
1002001
1002001
1002001
1002001
1002001
1002001
1002001
1002001
1002001
1002001
1002001
1002001
1002001
1002001
1002001
1002001
1002001
1002001
1002001
1002001
1002001
1002001
1002001
1002001
1002001
1002001
1002001
1002001
1002001
1002001
1002001
1002001
1002001
1002001
1002001
1002001
1002001
1002001
1002001
1002001
1002001
1002001
1002001
1002001
1002001
1002001
1002001
1002001
1002001
1002001
1002001
1002001
1002001
1002001
1002001
1002001
1002001
1002001
1002001
1002001
1002001
1002001
1002001
1002001
1002001
1002001
1002001
1002001
1002001
1002001
1002001
1002001
1002001
1002001
1002001
1002001
1002001
1002001
1002001
1002001
1002001
1002001
1002001
1002001
1002001
1002001
1002001
1002001
1002001
1002001
1002001
1002001
1002001
1002001
1002001
1002001
1002001
1002001
1002001
1002001
1002001
1002001
1002001
1002001
1002001
1002001
1002001
1002001
1002001
1002001
1002001
1002001
1002001
1002001
1002001
1002001
1002001
1002001
1002001
1002001
1002001
1002001
1002001
1002001
1002001
1002001
1002001
1002001
1002001
1002001
1002001
1002001
1002001
1002001
1002001
1002001
1002001
1002001
1002001
1002001
1002001
1002001
1002001
1002001
1002001
1002001
1002001
1002001
1002001
1002001
1002001
1002001
1002001
1002001
1002001
1002001
1002001
1002001
1002001
1002001
1002001
1002001
1002001
1002001
1002001
1002001
1002001
1002001
1002001
1002001
1002001
1002001
1002001
1002001
1002001
1002001
1002001
1002001
1002001
1002001
1002001
1002001
1002001
1002001
1002001
1002001
1002001
1002001
1002001
1002001
1002001
1002001
1002001
1002001
1002001
1002001
1002001
1002001
1002001
1002001
1002001
1002001
1002001
1002001
1002001
1002001
1002001
1002001
1002001
1002001
1002001
1002001
1002001
1002001
1002001
1002001
1002001
1002001
1002001
1002001
1002001
1002001
1002001
1002001
1002001
1002001
1002001
1002001
1002001
1002001
1002001
1002001
1002001
1002001
1002001
1002001
1002001
1002001
1002001
1002001
1002001
1002001
1002001
1002001
1002001
1002001
1002001
1002001
1002001
1002001
1002001
1002001
1002001
1002001
1002001
1002001
1002001
1002001
1002001
1002001
1002001
1002001
1002001
1002001
1002001
1002001
1002001
1002001
1002001
1002001
1002001
1002001
1002001
1002001
1002001
1002001
1002001
1002001
1002001
1002001
1002001
1002001
1002001
1002001
1002001
1002001
1002001
1002001
1002001
1002001
1002001
1002001
1002001
1002001
1002001
1002001
1002001
1002001
1002001
1002001
1002001
1002001
1002001
1002001
1002001
1002001
1002001
1002001
1002001
1002001
1002001
1002001
1002001
1002001
1002001
1002001
1002001
1002001
1002001
1002001
1002001
1002001
1002001
1002001
1002001
1002001
1002001
1002001
1002001
1002001
1002001
1002001
1002001
1002001
1002001
1002001
1002001
1002001
1002001
1002001
1002001
1002001
1002001
1002001
1002001
1002001
1002001
1002001
1002001
1002001
1002001
1002001
1002001
1002001
1002001
1002001
1002001
1002001
1002001
1002001
1002001
1002001
1002001
1002001
1002001
1002001
1002001
1002001
1002001
1002001
1002001
1002001
1002001
1002001
1002001
1002001
1002001
1002001
1002001
1002001
1002001
1002001
1002001
1002001
1002001
1002001
1002001
1002001
1002001
1002001
1002001
1002001
1002001
1002001
1002001
1002001
1002001
1002001
1002001
1002001
1002001
1002001
1002001
1002001
1002001
1002001
1002001
1002001
1002001
1002001
1002001
1002001
1002001
1002001
1002001
1002001
1002001
1002001
1002001
1002001
1002001
1002001
1002001
1002001
1002001
1002001
1002001
1002001
1002001
1002001
1002001
1002001
1002001
1002001
1002001
1002001
1002001
1002001
1002001
1002001
1002001
1002001
1002001
1002001
1002001
1002001
1002001
1002001
1002001
1002001
1002001
1002001
1002001
1002001
1002001
1002001
1002001
1002001
1002001
1002001
1002001
1002001
1002001
1002001
1002001
1002001
1002001
1002001
1002001
1002001
1002001
1002001
1002001
1002001
1002001
1002001
1002001
1002001
1002001
1002001
1002001
1002001
1002001
1002001
1002001
1002001
1002001
1002001
1002001
1002001
1002001
1002001
1002001
1002001
1002001
1002001
1002001
1002001
1002001
1002001
1002001
1002001
1002001
1002001
1002001
1002001
1002001
1002001
1002001
1002001
1002001
1002001
1002001
1002001
1002001
1002001
1002001
1002001
1002001
1002001
1002001
1002001
1002001
1002001
1002001
1002001
1002001
1002001
1002001
1002001
1002001
1002001
1002001
1002001
1002001
1002001
1002001
1002001
1002001
1002001
1002001
1002001
1002001
1002001
1002001
1002001
1002001
1002001
1002001
1002001
1002001
1002001
1002001
1002001
1002001
1002001
1002001
1002001
1002001
1002001
1002001
1002001
1002001
1002001
1002001
1002001
1002001
1002001
1002001
1002001
1002001
1002001
1002001
1002001
1002001
1002001
1002001
1002001
1002001
1002001
1002001
1002001
1002001
1002001
1002001
1002001
1002001
1002001
1002001
1002001
1002001
1002001
1002001
1002001
1002001
1002001
1002001
1002001
1002001
1002001
1002001
1002001
1002001
1002001
1002001
1002001
1002001
1002001
1002001
1002001
1002001
1002001
1002001
1002001
1002001
1002001
1002001
1002001
1002001
1002001
1002001
1002001
1002001
1002001
1002001
1002001
1002001
1002001
1002001
1002001
1002001
1002001
1002001
1002001
1002001
1002001
1002001
1002001
1002001
1002001
1002001
1002001
1002001
1002001
1002001
1002001
1002001
1002001
1002001
1002001
1002001
1002001
1002001
1002001
1002001
1002001
1002001
1002001
1002001
1002001
1002001
1002001
1002001
1002001
1002001
1002001
1002001
1002001
1002001
1002001
1002001
1002001
1002001
1002001
1002001
1002001
1002001
1002001
1002001
1002001
1002001
1002001
1002001
1002001
1002001
1002001
1002001
1002001
1002001
1002001
1002001
1002001
1002001
1002001
1002001
1002001
1002001
1002001
1002001
1002001
1002001
1002001
1002001
1002001
1002001
1002001
1002001
1002001
1002001
1002001
1002001
1002001
1002001
1002001
1002001
1002001
1002001
1002001
1002001
1002001
1002001
1002001
1002001
1002001
1002001
1002001
1002001
1002001
1002001
1002001
1002001
1002001
1002001
1002001
1002001
1002001
1002001
1002001
1002001
1002001
1002001
1002001
1002001
1002001
1002001
1002001
1002001
1002001
1002001
1002001
1002001
1002001
1002001
1002001
1002001
1002001
1002001
1002001
1002001
1002001
1002001
1002001
1002001
1002001
1002001
1002001
1002001
1002001
1002001
1002001
1002001
1002001
1002001
1002001
1002001
1002001
1002001
1002001
1002001
1002001
1002001
1002001
1002001
1002001
1002001
1002001
1002001
1002001
1002001
1002001
1002001
1002001
1002001
1002001
1002001
1002001
1002001
1002001
1002001
1002001
1002001
1002001
1002001
1002001
1002001
1002001
1002001
1002001
1002001
1002001
1002001
1002001
1002001
1002001
1002001
1002001
1002001
1002001
1002001
1002001
1002001
1002001
1002001
1002001
1002001
1002001
1002001
1002001
1002001
1002001
1002001
1002001
1002001
1002001
1002001
1002001
1002001
1002001
1002001
1002001
1002001
1002001
1002001
1002001
1002001
1002001
1002001
1002001
1002001
1002001
1002001
1002001
1002001
1002001
1002001
1002001
1002001
1002001
1002001
1002001
1002001
1002001
1002001
1002001
1002001
1002001
1002001
1002001
1002001
1002001
1002001
1002001
1002001
1002001
1002001
1002001
1002001
1002001
1002001
1002001
1002001
1002001
1002001
1002001
1002001
1002001
1002001
1002001
1002001
1002001
1002001
1002001
1002001
1002001
1002001
1002001
1002001
1002001
1002001
1002001
1002001
1002001
1002001
1002001
1002001
1002001
1002001
1002001
1002001
1002001
1002001
1002001
1002001
1002001
1002001
1002001
1002001
1002001
1002001
1002001
1002001
1002001
1002001
1002001
1002001
1002001
1002001
1002001
1002001
1002001
1002001
1002001
1002001
1002001
1002001
1002001
1002001
1002001
1002001
1002001
1002001
1002001
1002001
1002001
1002001
1002001
1002001
1002001
1002001
1002001
1002001
1002001
1002001
1002001
1002001
1002001
1002001
1002001
1002001
1002001
1002001
1002001
1002001
1002001
1002001
1002001
1002001
1002001
1002001
1002001
1002001
1002001
1002001
1002001
1002001
1002001
1002001
1002001
1002001
1002001
1002001
1002001
1002001
1002001
1002001
1002001
1002001
1002001
1002001
1002001
1002001
1002001
1002001
1002001
1002001
1002001
1002001
1002001
1002001
1002001
1002001
1002001
1002001
1002001
1002001
1002001
1002001
1002001
1002001
1002001
1002001
1002001
1002001
1002001
1002001
1002001
1002001
1002001
1002001
1002001
1002001
1002001
1002001
1002001
1002001
1002001
1002001
1002001
1002001
1002001
1002001
1002001
1002001
1002001
1002001
1002001
1002001
1002001
1002001
1002001
1002001
1002001
1002001
1002001
1002001
1002001
1002001
1002001
1002001
1002001
1002001
1002001
1002001
1002001
1002001
1002001
1002001
1002001
1002001
1002001
1002001
1002001
1002001
1002001
1002001
1002001
1002001
1002001
1002001
1002001
1002001
1002001
1002001
1002001
1002001
1002001
1002001
1002001
1002001
1002001
1002001
1002001
1002001
1002001
1002001
1002001
1002001
1002001
1002001
1002001
1002001
1002001
1002001
1002001
1002001
1002001
1002001
1002001
1002001
1002001
1002001
1002001
1002001
1002001
1002001
1002001
1002001
1002001
1002001
1002001
1002001
1002001
1002001
1002001
1002001
1002001
1002001
1002001
1002001
1002001
1002001
1002001
1002001
1002001
1002001
1002001
1002001
1002001
1002001
1002001
1002001
1002001
1002001
1002001
1002001
1002001
1002001
1002001
1002001
1002001
1002001
1002001
1002001
1002001
1002001
1002001
1002001
1002001
1002001
1002001
1002001
1002001
1002001
1002001
1002001
1002001
1002001
1002001
1002001
1002001
1002001
1002001
1002001
1002001
1002001
1002001
1002001
1002001
1002001
1002001
1002001
1002001
1002001
1002001
1002001
1002001
1002001
1002001
1002001
1002001
1002001
1002001
1002001
1002001
1002001
1002001
1002001
1002001
1002001
1002001
1002001
1002001
1002001
1002001
1002001
1002001
1002001
1002001
1002001
1002001
1002001
1002001
1002001
1002001
1002001
1002001
1002001
1002001
1002001
1002001
1002001
1002001
1002001
1002001
1002001
1002001
1002001
1002001
1002001
1002001
1002001
1002001
1002001
1002001
1002001
1002001
1002001
1002001
1002001
1002001
1002001
1002001
1002001
1002001
1002001
1002001
1002001
1002001
1002001
1002001
1002001
1002001
1002001
1002001
1002001
1002001
1002001
1002001
1002001
1002001
1002001
1002001
1002001
1002001
1002001
1002001
1002001
1002001
1002001
1002001
1002001
1002001
1002001
1002001
1002001
1002001
1002001
1002001
1002001
1002001
1002001
1002001
1002001
1002001
1002001
1002001
1002001
1002001
1002001
1002001
1002001
1002001
1002001
1002001
1002001
1002001
1002001
1002001
1002001
1002001
1002001
1002001
1002001
1002001
1002001
1002001
1002001
1002001
1002001
1002001
1002001
1002001
1002001
1002001
1002001
1002001
1002001
1002001
1002001
1002001
1002001
1002001
1002001
1002001
1002001
1002001
1002001
1002001
1002001
1002001
1002001
1002001
1002001
1002001
1002001
1002001
1002001
1002001
1002001
1002001
1002001
1002001
1002001
1002001
1002001
1002001
1002001
1002001
1002001
1002001
1002001
1002001
1002001
1002001
1002001
1002001
1002001
1002001
1002001
1002001
1002001
1002001
1002001
1002001
1002001
1002001
1002001
1002001
1002001
1002001
1002001
1002001
1002001
1002001
1002001
1002001
1002001
1002001
1002001
1002001
1002001
1002001
1002001
1002001
1002001
1002001
1002001
1002001
1002001
1002001
1002001
1002001
1002001
1002001
1002001
1002001
1002001
1002001
1002001
1002001
1002001
1002001
1002001
1002001
1002001
1002001
1002001
1002001
1002001
1002001
1002001
1002001
1002001
1002001
1002001
1002001
1002001
1002001
1002001
1002001
1002001
1002001
1002001
1002001
1002001
1002001
1002001
1002001
1002001
1002001
1002001
1002001
1002001
1002001
1002001
1002001
1002001
1002001
1002001
1002001
1002001
1002001
1002001
1002001
1002001
1002001
1002001
1002001
1002001
1002001
1002001
1002001
1002001
1002001
1002001
1002001
1002001
1002001
1002001
1002001
1002001
1002001
1002001
1002001
1002001
1002001
1002001
1002001
1002001
1002001
1002001
1002001
1002001
1002001
1002001
1002001
1002001
1002001
1002001
1002001
1002001
1002001
1002001
1002001
1002001
1002001
1002001
1002001
1002001
1002001
1002001
1002001
1002001
1002001
1002001
1002001
1002001
1002001
1002001
1002001
1002001
1002001
1002001
1002001
1002001
1002001
1002001
1002001
1002001
1002001
1002001
1002001
1002001
1002001
1002001
1002001
1002001
1002001
1002001
1002001
1002001
1002001
1002001
1002001
1002001
1002001
1002001
1002001
1002001
1002001
1002001
1002001
1002001
1002001
1002001
1002001
1002001
1002001
1002001
1002001
1002001
1002001
1002001
1002001
1002001
1002001
1002001
1002001
1002001
1002001
1002001
1002001
1002001
1002001
1002001
1002001
1002001
1002001
1002001
1002001
1002001
1002001
1002001
1002001
1002001
1002001
1002001
1002001
1002001
1002001
1002001
1002001
1002001
1002001
1002001
1002001
1002001
1002001
1002001
1002001
1002001
1002001
1002001
1002001
1002001
1002001
1002001
1002001
1002001
1002001
1002001
1002001
1002001
1002001
1002001
1002001
1002001
1002001
1002001
1002001
1002001
1002001
1002001
1002001
1002001
1002001
1002001
1002001
1002001
1002001
1002001
1002001
1002001
1002001
1002001
1002001
1002001
1002001
1002001
1002001
1002001
1002001
1002001
1002001
1002001
1002001
1002001
1002001
1002001
1002001
1002001
1002001
1002001
1002001
1002001
1002001
1002001
1002001
1002001
1002001
1002001
1002001
1002001
1002001
1002001
1002001
1002001
1002001
1002001
1002001
1002001
1002001
1002001
1002001
1002001
1002001
1002001
1002001
1002001
1002001
1002001
1002001
1002001
1002001
1002001
1002001
1002001
1002001
1002001
1002001
1002001
1002001
1002001
1002001
1002001
1002001
1002001
1002001
1002001
1002001
1002001
1002001
1002001
1002001
1002001
1002001
1002001
1002001
1002001
1002001
1002001
1002001
1002001
1002001
1002001
1002001
1002001
1002001
1002001
1002001
1002001
1002001
1002001
1002001
1002001
1002001
1002001
1002001
1002001
1002001
1002001
1002001
1002001
1002001
1002001
1002001
1002001
1002001
1002001
1002001
1002001
1002001
1002001
1002001
1002001
1002001
1002001
1002001
1002001
1002001
1002001
1002001
1002001
1002001
1002001
1002001
1002001
1002001
1002001
1002001
1002001
1002001
1002001
1002001
1002001
1002001
1002001
1002001
1002001
1002001
1002001
1002001
1002001
1002001
1002001
1002001
1002001
1002001
1002001
1002001
1002001
1002001
1002001
1002001
1002001
1002001
1002001
1002001
1002001
1002001
1002001
1002001
1002001
1002001
1002001
1002001
1002001
1002001
1002001
1002001
1002001
1002001
1002001
1002001
1002001
1002001
1002001
1002001
1002001
1002001
1002001
1002001
1002001
1002001
1002001
1002001
1002001
1002001
1002001
1002001
1002001
1002001
1002001
1002001
1002001
1002001
1002001
1002001
1002001
1002001
1002001
1002001
1002001
1002001
1002001
1002001
1002001
1002001
1002001
1002001
1002001
1002001
1002001
1002001
1002001
1002001
1002001
1002001
1002001
1002001
1002001
1002001
1002001
1002001
1002001
1002001
1002001
1002001
1002001
1002001
1002001
1002001
1002001
1002001
1002001
1002001
1002001
1002001
1002001
1002001
1002001
1002001
1002001
1002001
1002001
1002001
1002001
1002001
1002001
1002001
1002001
1002001
1002001
1002001
1002001
1002001
1002001
1002001
1002001
1002001
1002001
1002001
1002001
1002001
1002001
1002001
1002001
1002001
1002001
1002001
1002001
1002001
1002001
1002001
1002001
1002001
1002001
1002001
1002001
1002001
1002001
1002001
1002001
1002001
1002001
1002001
1002001
1002001
1002001
1002001
1002001
1002001
1002001
1111111