R 50000000000000000000000000 5000

NO ./pics/MOB.xpm
WE ./pics/purplestone.xpm
EA ./pics/colorstone.xpm
SO ./pics/redbrick.xpm
S ./pics/pillar.xpm

C  80,150,10
F  20,40,80

             11111111111111
             10000000111111
             10000000000001
             10000E00000001
             10020000000001
             10000020000001
111111111111111000000000111
100000000000000000000000001
100000000000000200000000001
100020000000000000000200001
100000000000000000000000001
100020000000000000000000001
111111111111111111111111111