R 1200 800

NO ./pics/MOB.xpm
WE ./pics/purplestone.xpm
EA ./pics/colorstone.xpm
SO ./pics/redbrick.xpm
S ./pics/pillar.xpm


C  120,30,60
F  255,190,50

11111
12N21
12021
12021
12021
12021
12021
12021
12021
12021
12021
12021
12021
12021
12021
12021
12021
12021
12021
12021
12021
12021
12021
12021
12021
12021
12021
12021
12021
12021
12021
12021
12021
12021
12021
12021
12021
12021
12021
12021
12021
12021
12021
12021
12021
12021
12021
12021
12021
12021
12021
12021
12021
12021
12021
12021
12021
12021
12021
12021
12021
12021
12021
12021
12021
12021
12021
12021
12021
12021
12021
12021
12021
12021
12021
12021
12021
12021
12021
12021
12021
12021
12021
12021
12021
12021
12021
12021
12021
12021
12021
12021
12021
12021
12021
12021
12021
12021
12021
12021
12021
12021
12021
12021
12021
12021
12021
12021
12021
12021
12021
12021
12021
12021
12021
12021
12021
12021
12021
12021
12021
12021
12021
12021
12021
12021
12021
12021
12021
12021
12021
12021
12021
12021
12021
12021
12021
12021
12021
12021
12021
12021
12021
12021
12021
12021
12021
12021
12021
12021
12021
12021
12021
12021
12021
12021
12021
12021
12021
12021
12021
12021
12021
12021
12021
12021
12021
12021
12021
12021
12021
12021
12021
12021
12021
12021
12021
12021
12021
12021
12021
12021
12021
12021
12021
12021
12021
12021
12021
12021
12021
12021
12021
12021
12021
12021
12021
12021
12021
12021
12021
12021
12021
12021
12021
12021
12021
12021
12021
12021
12021
12021
12021
12021
12021
12021
12021
12021
12021
12021
12021
12021
12021
12021
12021
12021
12021
12021
12021
12021
12021
12021
12021
12021
12021
12021
12021
12021
12021
12021
12021
12021
12021
12021
12021
12021
12021
12021
12021
12021
12021
12021
12021
12021
12021
12021
12021
12021
12021
12021
12021
12021
12021
12021
12021
12021
12021
12021
12021
12021
12021
12021
12021
12021
12021
12021
12021
12021
12021
12021
12021
12021
12021
12021
12021
12021
12021
12021
12021
12021
12021
12021
12021
12021
12021
12021
12021
12021
12021
12021
12021
12021
12021
12021
12021
12021
12021
12021
12021
12021
12021
12021
12021
12021
11111