R 40000000 505000000

S ./pics/smth_special/S.xpm
NO ./pics/smth_special/1.xpm
WE ./pics/smth_special/2.xpm
EA ./pics/smth_special/3.xpm
SO ./pics/smth_special/1.xpm

C  80,180,120
F  30,20,50

11111111111111111111111111111111111111
10000000000000000000000000000000000001
10020020000001111111111111111000020001
10000000000001111111111111111000220001
10020020000000000000000000000000000001
10000000100000000111000000001000000001
10000001 100000001 1000000001110000001
10000001 10000000111000111000010000001
100000011101111000000001 1000010000001
100000000001  1000N00001 1000010000001
10001110000111100000000111000110000001
10001 10000000000000000000000100000001
10001 10000011111111111111110100000001
10001 1002001              10100000001
10001 10020011111111111111110100002001
10001110020000000000000000000100020201
10000000020000000000000000000100002001
10001111111111111111111111111100000001
10000000000000000000000000000000000001
11111111111111111111111111111111111111